*******
*   *  
*   *
*   *
*   *
*   *
0